11111111111111111111111111111111111111111111111111111111111111111
1E000000000000000C00000000000C111111111111000000000011111111111C1
1000C111111111111111111111111000000000000001111111100000000000001
1110000000000000C111111100000001111111111111000000000000000000001
1C0000000000000000000010001000000000000000000000001111111111111C1
100000000000000000000000000000000001000100010000C00000000000000P1
11111111111111111111111111111111111111111111111111111111111111111