1111111111
110PEC1111
1100000001
1000000001
1111111111