11111111111
1CE00CP0C01
1C10000CXC1
11111111111