1111111111
1000000001
110PEC0011
1100000X01
1000000001
1111111111