11111111111111
1CPE0000000111
11001111111111
1C00000001C001
11111111111111